11111111111111111111111111
10C10000000C00000000000E01
111100000000C0C00000001111
10C00000000000000P00001001
10000000000000C00000001001
11111111111111111111111111
