11111111111111111111111111
10C000000000000000000001E1
100000000000C0C00000001111
10C00000000000000P00001001
10000000000000C00000001001
11111111111111111111111111
