111111111
1P000C001
100010001
1000000E1
111111111
