1111111111111111111111
100001111001000C000CE1
100000C0100100000000C1
1000000000000C00000001
10001111000000000000C1
1000000100C0000C000001
10000001000000000000C1
100000P100000C00000001
1111111111111111111111
