111111111\n
1P000C001\n
100010001\n
1000000E1\n
111111111\n
