11111111111111111111111111111111111111111111111111111111111111111111111111111111111111111111111111111111111111111111111111
1C000000000000000000000000000000000000000000000000000000000000000000000000000000000000000000000000000000000000000000000001
10111111111111111111111111111111111111111111111111111111111111111111111111111111111111111111111111111111111111111111100001
10100000000000000000000000000000000000000000000000000000000000000000000000000000000000000000000000000000000000000000001001
10101111111111111111111111111111111111111111111111111111111111111111111111111111111111111111111111111111111111111110100001
10100000000000000000000000000000000000000P00000000000000000000000000000000000000000000000000000000000000000000000000001001
10101111111111111111111111111111111111111111111111111111111111111111111111111111111111111111111111111111111111111110100001
10100000000000000000000000000000000000000000000000000000000000000000000000000000000000000000000000000000000000000000001001
10101111111111111111111111111111111111111111111111111111111111111111111111111111111111111111111111111111111111111110100001
10100000000000000000000000000000000000000000000000000000000000000000000000000000000000000000000000000000000000000000001001
10101111111111111111111111111111111111111111111111111111111111111111111111111111111111111111111111111111111111111110100001
10100000000000000000000000000000000000000000000000000000000000000000000000000000000000000000000000000000000000000000001001
10101111111111111111111111111111111111111111111111111111111111111111111111111111111111111111111111111111111111111110100001
10100000000000000000000000000000000000000000000000000000000000000000000000000000000000000000000000000000000000000000001001
101011111111111111111111111111111111111111111111111111111111111111111111111111111111111111111111111111111111111111101000C1
10100000000000000000000000000000000000000000000000000000000000000000000000000000000000000000000000000000000000000000001001
10101111111111111111111111111111111111111111111111111111111111111111111111111111111111111111111111111111111111111110100001
10100000000000000000000000000000000000000000000000000000000000000000000000000000000000000000000000000000000000000000001001
10101111111111111111111111111111111111111111111111111111111111111111111111111111111111111111111111111111111111111110100001
10100000000000000000000000000000000000000000000000000000000000000000000000000000000000000000000000000000000000000000001001
10101111111111111111111111111111111111111111111111111111111111111111111111111111111111111111111111111111111111111110100001
10100000000000000000000000000000000000000000000000000000000000000000000000000000C00000000000000000000000000000000000001001
10101111111111111111111111111111111111111111111111111111111111111111111111111111111111111111111111111111111111111110100001
10100000000000000000000000000000000000000000000000000000000000000000000000000000000000000000000000000000000000000000001001
10101111111111111111111111111111111111111111111111111111111111111111111111111111111111111111111111111111111111111110100001
10100000000000000000000000000000000000000000000000000000000000000000000000000000000000000000000000000000000000000000001001
10101111111111111111111111111111111111111111111111111111111111111111111111111111111111111111111111111111111111111110100001
10100000000000000000000000000000000000000000000000000000000000000000000000000000000000000000000000000000000000000000001001
10101111111111111111111111111111111111111111111111111111111111111111111111111111111111111111111111111111111111111110100001
10100000000000000000000000000000000000000000000000000000000000000000000000000000000000000000000000000000000000000000001001
10101111111111111111111111111111111111111111111111111111111111111111111111111111111111111111111111111111111111111110100001
10100000000000000000000000000000000000000000000000000000000000000000000000000000000000000000000000000000000000000000001001
10101111111111111111111111111111111111111111111111111111111111111111111111111111111111111111111111111111111111111110100001
10100000000000000000000000000000000000000000000000000000000000000000000000000000000000000000000000000000000000000000001001
10101111111111111111111111111111111111111111111111111111111111111111111111111111111111111111111111111111111111111110100001
10100000000000000000000000000000000000000000000000000000000000000000000000000000000000000000000000000000000000000000001001
10101111111111111111111111111111111111111111111111111111111111111111111111111111111111111111111111111111111111111110100001
10100000000000000000000000000000000000000000000000000000000000000000000000000000000000000000000000000000000000000000001001
10101111111111111111111111111111111111111111111111111111111111111111111111111111111111111111111111111111111111111110100001
10100000000000000000000000000000000000000000000000000000000000000000000000000000000000000000000000000000000000000000001001
10101111111111111111111111111111111111111111111111111111111111111111111111111111111111111111111111111111111111111110100001
10100000000000000000000000000000000000000000000000000000000000000000000000000000000000000000000000000000000000000000001001
10101111111111111111111111111111111111111111111111111111111111111111111111111111111111111111111111111111111111111110100001
10100000000000000000000000000000000000000000000000000000000000000000000000000000000000000000000000000000000000000000001001
10101111111111111111111111111111111111111111111111111111111111111111111111111111111111111111111111111111111111111110100001
10100000000000000000000000000000000000000000000000000000000000000000000000000000000000000000000000000000000000000000001001
10101111111111111111111111111111111111111111111111111111111111111111111111111111111111111111111111111111111111111110100001
10100000000000000000000000000000000000000000000000000000000000000000000000000000000000000000000000000000000000000000001001
10101111111111111111111111111111111111111111111111111111111111111111111111111111111111111111111111111111111111111110100001
10100000000000000000000000000000000000000000000000000000000000000000000000000000000000000000000000000000000000000000001001
10101111111111111111111111111111111111111111111111111111111111111111111111111111111111111111111111111111111111111110100001
10100000000000000000000000000000000000000000000000000000000000000000000000000000000000000000000000000000000000000000001001
10101111111111111111111111111111111111111111111111111111111111111111111111111111111111111111111111111111111111111110100001
1C100000000000000000000000000000000000000000000000000000000000000000000000000000000000000000000000000000000000000000001001
10101111111111111111111111111111111111111111111111111111111111111111111111111111111111111111111111111111111111111110100001
10100000000000000000000000000000000000000000000000000000000000000000000000000000000000000000000000000000000000000000001001
101C1111111111111111111111111111111111111111111111111111111111111111111111111111111111111111111111111111111111111110100001
10100000000000000000000000000000000000000000000000000000000000000000000000000000000000000000000000000000000000E00000000001
10111111111111111111111111111111111111111111111111111111111111111111111111111111111111111111111111111111111111111111100001
110000000000000000000000000000000C000000000000000000000000C00000000000000000000000000000000000000000000000000000000000C001
11111111111111111111111111111111111111111111111111111111111111111111111111111111111111111111111111111111111111111111111111
