11111111111111111111111111111111111111111111111
10000000000000000000000000000000000000000000001
10000111001000000000000001010000000000010111011
1000100000100000000000000101101000000001C101001
10001011001000000000000001C00000000000011101C01
10001010001000000001111000000000000000000001001
10011010001111111111001C11111111110000000011001
100100110000000000000011100000000C0000000000001
10010001000000000000000111111000100000000000001
10010001000000000000000100000000100000000000101
10110001000000000111111001111011100000000001101
1EC1C0010000000001P0000001000C00000000000000C11
11111111111111111111111111111111111111111111111
