111111111
1PCCCCCC1
1CCCCCCC1
1CCCCCCE1
111111111
