1111111111111
1P0100C000001
101011111C101
1010000001001
1011101111001
1000000000001
1111110111E11
1111111111111
