111111111
1000000C1
1N0000001
1PE000C01
111111111
