111111111
1PCCCCCC1
1CCCCCCC1
1CCCCCCC1
111111111
