11111111111111111111111111111111111111111111111
10000010000001000000000000000000100000000000001
10010C10000001010111111000000000101000000000101
10011110000001010110001000000000101000001111101
1N00000000000101111C001000000000101000001000001
11111110000001000011101000000000101000001010101
10000000000101110000101000000000101000001010101
100000000001000111110010000N0000101000001010101
10000000000101000000001000000000101000001C1C1C1
10000000000101111111111000000000101000001111111
10000000000101000000000000000000101000001000001
100000000001010000000000000000001011111C1C11101
10000000000101000000000000000000100000111111101
10000000000100000000000000000000100000000000001
10000111001001000110111101010000100000010111011
1000100000101100010000000101101000000001C101001
1000101100101111110100C001C00000000000011101C01
100010100010000000011110000N0000000000000001001
10011010001111111111001C11111111110000000011001
100100110000000000000010000000000C0000000000001
10010001000000000000000111111000100000000000001
10010001000000000000000100000000100000000000101
10010001000000000111111001111011100000000001101
1000C0010000000001P0000001000C00000000000000CE1
11111111111111111111111111111111111111111111111
