111111111
1PCCCCCC1
1CCCCCCN1
1CCCCCCE1
111111111
