1111111
1P1C0E1
1001011
1000011
1111111
