11111111111111111111111111
10C000000000000000000000E1
100000000000C0000000001111
10000000000000000000001001
1000P000000000C00000001001
11111111111111111111111111
