11111111111111111111111111
10C000000000000000000000E1
100000000000C0C00000001111
100000000000000000000010011
1000P000000000C00000001001
11111111111111111111111111
